{
	"map":[
                [2, 2, 2, 2, 2, 2, 2, 2, 2, 2, 2, 2, 2, 2, 2, 2, 2, 2, 2, 2, 2, 2, 2, 2, 2, 2, 2, 2, 2, 2, 2],
                [2, 2, 2, 2, 2, 2, 2, 2, 2, 2, 2, 2, 2, 2, 2, 2, 2, 2, 2, 2, 2, 2, 2, 2, 2, 2, 2, 2, 2, 2, 2],
                [2, 2, 2, 2,20, 0, 0, 0, 0, 0, 0, 0, 0, 0, 0, 0, 0, 0, 0, 0, 0, 0, 0, 0, 0, 0, 0, 2, 2, 2, 2],
                [2, 2, 2, 2,21,19,19,19,19,19,19,19,19,19,19,19,19,50, 0, 0, 0, 0, 0, 0, 0, 0, 0, 2, 2, 2, 2],
                [2, 2, 2, 2, 0, 0, 0, 0, 0, 0, 0, 0, 0, 0, 0, 0, 0, 0, 0, 0, 0, 0, 0, 0, 0, 0, 0, 2, 2, 2, 2],
                [2, 2, 2, 2, 0, 0, 0, 0, 0, 0, 0, 0, 0, 0, 0, 0, 0, 0, 0, 0, 0, 0, 0, 0, 0, 0, 0, 2, 2, 2, 2],
                [2, 2, 2, 2, 0, 0, 0, 0, 0, 0, 0, 0, 0, 0, 0, 0, 0, 0, 0, 0, 0, 0, 0, 0, 0, 0, 0, 2, 2, 2, 2],
                [2, 2, 2, 2, 0, 0, 0, 0, 0, 0, 0, 0, 0, 0, 0, 0, 0, 0, 0, 0, 0, 0, 0, 0, 0, 0, 0, 2, 2, 2, 2],
                [2, 2, 2, 2, 0, 0, 0, 0, 0, 0, 0, 0, 0, 0, 0, 0, 0, 0, 0, 0, 0, 0, 0, 0, 0, 0, 0, 2, 2, 2, 2],
                [2, 2, 2, 2, 0, 0, 0, 0, 0, 0, 0, 0, 0, 0, 0, 0, 0, 0, 0, 0, 0, 0, 0, 0, 0, 0, 0, 2, 2, 2, 2],
                [2, 2, 2, 2, 0, 0, 0, 0, 0, 0, 0, 0, 0, 0,54, 0, 0, 0, 0, 0, 0, 0, 0, 0, 0, 0, 0, 2, 2, 2, 2],
                [2, 2, 2, 2, 0, 0, 0, 0, 0, 0, 0, 0, 0, 0,20, 0, 0, 0, 0, 0, 0, 0, 0, 0, 0, 0, 0, 2, 2, 2, 2],
                [2, 2, 2, 2, 0,51,19,63, 0, 0, 0, 0, 0, 0,20, 0, 0, 0, 0, 0, 0, 0, 0, 0, 0, 0, 0, 2, 2, 2, 2],
                [2, 2, 2, 2, 0, 0, 0,21,63, 0, 0, 0, 0, 0,20, 0, 0, 0, 0, 0, 0, 0, 0, 0, 0, 0, 0, 2, 2, 2, 2],
                [2, 2, 2, 2, 0, 0, 0, 0,21,19,63, 0, 0, 0,20, 0, 0, 0, 0, 0, 0, 0, 0, 0, 0, 0, 0, 2, 2, 2, 2],
                [2, 2, 2, 2, 0, 0, 0, 0, 0, 0,21,19,19,19,53,19,19,19,19,19,19,50, 0, 0, 0, 0, 0, 2, 2, 2, 2],
                [2, 2, 2, 2, 0, 0, 0, 0, 0, 0, 0, 0, 0,62,61, 0, 0, 0, 0, 0, 0, 0, 0, 0, 0, 0, 0, 2, 2, 2, 2],
                [2, 2, 2, 2, 0, 0, 0, 0, 0, 0, 0, 0, 0,20, 0, 0, 0, 0, 0, 0, 0, 0, 0, 0, 0, 0, 0, 2, 2, 2, 2],
                [2, 2, 2, 2, 0, 0, 0, 0, 0, 0, 0, 0, 0,20, 0, 0, 0, 0, 0, 0, 0, 0, 0, 0, 0, 0, 0, 2, 2, 2, 2],
                [2, 2, 2, 2, 0, 0, 0, 0, 0, 0, 0,62,19,68, 0, 0, 0, 0, 0, 0, 0, 0, 0, 0, 0, 0, 0, 2, 2, 2, 2],
                [2, 2, 2, 2, 0, 0, 0, 0,62,19,19,61, 0,21,63, 0, 0, 0, 0, 0, 0, 0, 0, 0, 0, 0, 0, 2, 2, 2, 2],
                [2, 2, 2, 2, 0, 0, 0, 0,20, 0, 0, 0, 0, 0,21,63, 0, 0, 0, 0, 0, 0, 0, 0, 0, 0, 0, 2, 2, 2, 2],
                [2, 2, 2, 2, 0, 0, 0,62,61, 0, 0, 0, 0, 0, 0,21,19,19,19,19,19,50, 0, 0, 0, 0, 0, 2, 2, 2, 2],
                [2, 2, 2, 2, 0, 0, 0,20, 0, 0, 0, 0, 0, 0, 0, 0, 0, 0, 0, 0, 0, 0, 0, 0, 0, 0, 0, 2, 2, 2, 2],
                [2, 2, 2, 2, 0, 0, 0,20, 0, 0, 0, 0, 0, 0, 0, 0, 0, 0, 0, 0, 0, 0, 0, 0, 0, 0, 0, 2, 2, 2, 2],
                [2, 2, 2, 2, 0, 0, 0,20, 0, 0, 0, 0, 0, 0, 0, 0, 0, 0, 0, 0, 0, 0, 0, 0, 0, 0, 0, 2, 2, 2, 2],
                [2, 2, 2, 2, 0, 0, 0,20, 0, 0, 0, 0, 0, 0, 0, 0, 0, 0, 0, 0, 0, 0, 0, 0, 0, 0, 0, 2, 2, 2, 2],
                [2, 2, 2, 2, 0, 0, 0,44, 0, 0, 0, 0, 0, 0, 0, 0, 0, 0, 0, 0, 0, 0, 0, 0, 0, 0, 0, 2, 2, 2, 2],
                [2, 2, 2, 2, 0, 0, 0,45, 0, 0, 0, 0, 0, 0, 0, 0, 0, 0, 0, 0, 0, 0, 0, 0, 0, 0, 0, 2, 2, 2, 2],
                [2, 2, 2, 2,48,48,48,48,48,48,48,48,48,48,48,48,48,48,76,48,48,48,70,70,70,70,70, 2, 2, 2, 2],
                [2, 2, 2, 2,48,48,48,48,48,48,48,48,48,48,48,48,48,48,76,48,48,48,70,70,70,70,70, 2, 2, 2, 2],
                [2, 2, 2, 2,48,48,48,48,48,48,48,48,48,48,48,48,48,48,76,48,48,48,70,70,70,70,70, 2, 2, 2, 2],
                [2, 2, 2, 2,48,48,48,48,48,48,48,48,48,48,48,48,48,48,76,48,48,48,70,70,70,70,70, 2, 2, 2, 2],
                [2, 2, 2, 2,48,48,48,48,48,48,48,48,48,48,48,48,48,48,76,48,48,48,70,70,70,70,70, 2, 2, 2, 2],
                [2, 2, 2, 2,48,48,48,48,48,48,48,48,48,48,48,48,48,48,76,48,48,48,70,70,70,70,70, 2, 2, 2, 2],
                [2, 2, 2, 2,48,48,48,48,48,48,48,48,48,48,48,48,48,48,76,48,48,48,70,70,70,70,70, 2, 2, 2, 2],
                [2, 2, 2, 2, 2, 2, 2, 2, 2, 2, 2, 2, 2, 2, 2, 2, 2, 2, 2, 2, 2, 2, 2, 2, 2, 2, 2, 2, 2, 2, 2],
                [2, 2, 2, 2, 2, 2, 2, 2, 2, 2, 2, 2, 2, 2, 2, 2, 2, 2, 2, 2, 2, 2, 2, 2, 2, 2, 2, 2, 2, 2, 2],
                [2, 2, 2, 2, 2, 2, 2, 2, 2, 2, 2, 2, 2, 2, 2, 2, 2, 2, 2, 2, 2, 2, 2, 2, 2, 2, 2, 2, 2, 2, 2]
			]
}
