{
    "map":[
                [0, 0, 0, 0, 0, 0, 0, 0, 0, 0, 0, 0, 0, 0, 0, 0, 0, 0, 0, 0, 0, 0, 0, 0, 0, 0, 0, 0, 0, 0, 0],
                [0, 0, 0, 0, 0, 0, 0, 0, 0, 0, 0, 0, 0, 0, 0, 0, 0, 0, 0, 0, 0, 0, 0, 0, 0, 0, 0, 0, 0, 0, 0],
                [0, 0, 0, 0, 0, 0,36, 0, 0,35,12, 0,34, 0,36, 0,52, 0,34,65, 4, 5, 4, 5, 4, 5, 0, 0, 0, 0, 0],
                [0, 0, 0, 0, 0, 0, 0, 0, 0, 0, 0, 0, 0, 0, 0, 0, 0, 0, 0,36, 6, 8, 9, 8, 9, 7, 0, 0, 0, 0, 0],
                [0, 0, 0, 0,65, 0, 0, 0,36,35,12, 0,35, 0,34,52,34, 0, 0, 0, 4, 9, 8, 9, 8, 5, 0, 0, 0, 0, 0],
                [0, 0, 0, 0,11,11,11,11,11,11,18, 0,65, 0, 0, 0, 0, 0,52,65, 6, 7, 6, 7, 6, 7, 0, 0, 0, 0, 0],
                [0, 0, 0, 0, 4, 5, 4, 5, 4, 5, 4, 5, 4, 5, 4, 5, 4, 5, 4, 5, 4, 5, 4, 5, 4, 5, 0, 0, 0, 0, 0],
                [0, 0, 0, 0, 6, 8, 9, 8, 9, 8, 9, 8, 9, 8, 9, 8, 9, 8, 9, 8, 9, 8, 9, 8, 9, 8, 5, 0, 0, 0, 0],
                [0, 0, 0, 0, 4, 9, 8, 9, 8, 9, 8, 9, 8, 9, 8, 9, 8, 9, 8, 9, 8, 9, 8, 9, 8, 9, 7, 0, 0, 0, 0],
                [0, 0, 0, 0, 6, 7, 6, 7, 6, 8, 9, 8, 9, 7, 6, 7,32,33, 6, 8, 9, 8, 9, 8, 9, 8, 5, 0, 0, 0, 0],
                [0, 0, 0, 0,56, 0, 0,34, 0, 6, 8, 9, 7, 0, 0, 0, 6, 7,36, 6, 7, 6, 7, 6, 7, 6, 7, 0, 0, 0, 0],
                [0, 0, 0, 0,57, 0,35, 0, 0, 4, 9, 8, 5, 0, 0, 0, 4, 5, 4, 5, 4, 5, 4, 5, 4, 5, 0, 0, 0, 0, 0],
                [0, 0, 0, 0, 0, 0, 0, 0, 0, 6, 8, 9, 7, 0, 0, 0, 6, 8, 9, 8, 9, 8, 9, 8, 9, 8, 5, 0, 0, 0, 0],
                [0, 0, 0, 0, 0, 0,12, 0, 0, 0, 6, 7,36, 0, 0, 0,36, 6, 8, 9, 8, 9, 7, 6, 8, 9, 7, 0, 0, 0, 0],
                [0, 0, 0, 0, 0, 0,16,11, 0, 0, 0,34, 0, 0, 0,34,52, 0, 6, 7, 6, 7,34, 0,32,33, 0, 0, 0, 0, 0],
                [0, 0, 0, 0,34, 4, 5, 4, 5, 0, 0, 0, 0, 0, 0, 0, 0, 0, 0, 0, 0, 0, 0, 0, 6, 8, 5, 0, 0, 0, 0],
                [0, 0, 0, 0, 4, 9, 8, 9, 8, 5, 4, 5, 0, 0, 0,36, 0,34,36,11,11,11,11,11,11,32,33, 0, 0, 0, 0],
                [0, 0, 0, 0, 6, 7, 6, 7, 6, 8, 9, 7, 0, 0, 0,34, 0, 0, 4, 5, 4, 5, 4, 5, 4, 9, 7, 0, 0, 0, 0],
                [0, 0, 0, 0,64,64,64,64,64, 6, 7, 0,34, 0, 0, 0,36, 4, 9, 8, 9, 8, 9, 8, 9, 8, 5, 0, 0, 0, 0],
                [0, 0, 0, 0,65,34,65, 0, 0, 0, 0, 0, 0, 0, 0, 0, 4, 9, 7, 6, 7, 6, 7, 6, 7,32,33, 0, 0, 0, 0],
                [0, 0, 0, 0, 0, 0, 0,34, 0, 0, 0, 0,65, 0, 0,34, 6, 7,34, 0, 0, 0,58, 0, 0,32,33, 0, 0, 0, 0],
                [0, 0, 0, 0, 0,36, 0, 0, 0,34, 0, 4, 5,65, 0, 0, 0, 0, 0, 0, 0, 0,59, 0, 0,32,33, 0, 0, 0, 0],
                [0, 0, 0, 0,34,36, 0, 0, 0, 0, 4, 9, 8, 5,52, 0, 0, 0, 0, 0, 0, 0, 0, 0, 0,32,33, 0, 0, 0, 0],
                [0, 0, 0, 0, 4, 5, 0, 0, 0, 4, 9, 8, 9, 8, 5, 4, 5, 4, 5, 4, 5, 4, 5, 4, 5,32,33, 0, 0, 0, 0],
                [0, 0, 0, 0,32,33, 0, 0, 0, 6, 8, 9, 8, 9, 8, 9, 8, 9, 8, 9, 8, 9, 8, 9, 8, 9, 7, 0, 0, 0, 0],
                [0, 0, 0, 0,32,33, 0, 0, 0, 4, 9, 8, 9, 8, 9, 8, 9, 8, 9, 8, 9, 8, 9, 8, 9, 8, 5, 0, 0, 0, 0],
                [0, 0, 0, 0, 6, 7,38, 0,39, 6, 7, 6, 7, 6, 7, 6, 7, 6, 7, 6, 7, 6, 7, 6, 7, 6, 7, 0, 0, 0, 0],
                [0, 0, 0, 0,46,46,40, 0,41,46, 2,46,46,46,46, 2,46,46,46,46,46, 2,46,46,46,46,46, 0, 0, 0, 0],
                [0, 0, 0, 0,47,47,42, 0,43,47,46,47,47,47,47, 2,47,47,47,47,47, 2,47,47,47,47,47, 0, 0, 0, 0],
                [0, 0, 0, 0, 0, 0, 0, 0, 0, 0,47, 0, 0, 0, 0,46, 0, 0, 0, 0, 0, 2, 0, 0, 0, 0, 0, 0, 0, 0, 0],
                [0, 0, 0, 0, 0, 0, 0, 0, 0, 0, 0, 0, 0, 0, 0,47, 0, 0, 0, 0, 0, 2, 0, 0, 0, 0, 0, 0, 0, 0, 0],
                [0, 0, 0, 0, 0, 0, 0, 0, 0, 0, 0, 0, 0, 0, 0, 0, 0, 0, 0, 0, 0, 2, 0, 0, 0, 0, 0, 0, 0, 0, 0],
                [0, 0, 0, 0, 2, 0, 2, 2, 2, 2, 2, 0, 0, 0, 0, 0, 0, 0, 0, 0, 0, 2, 0, 0, 0, 0, 0, 0, 0, 0, 0],
                [0, 0, 0, 0, 0, 0, 0, 0, 0, 0, 2, 0, 0, 0, 0, 0, 0, 0, 0, 0, 0, 2, 0, 0, 0, 0, 0, 0, 0, 0, 0],
                [0, 0, 0, 0, 0, 0, 0, 0, 0, 0, 2, 0, 0, 0, 0, 2, 0, 0, 0, 0, 0, 2, 0, 0, 0, 0, 0, 0, 0, 0, 0],
                [0, 0, 0, 0, 0,77, 0, 0, 0, 0, 2,77, 0, 0, 0, 2, 0, 0, 0, 0, 0, 2, 0, 0, 0, 0, 0, 0, 0, 0, 0],
                [0, 0, 0, 0, 0, 0, 0, 0, 0, 0, 0, 0, 0, 0, 0, 0, 0, 0, 0, 0, 0, 0, 0, 0, 0, 0, 0, 0, 0, 0, 0],
                [0, 0, 0, 0, 0, 0, 0, 0, 0, 0, 0, 0, 0, 0, 0, 0, 0, 0, 0, 0, 0, 0, 0, 0, 0, 0, 0, 0, 0, 0, 0],
                [0, 0, 0, 0, 0, 0, 0, 0, 0, 0, 0, 0, 0, 0, 0, 0, 0, 0, 0, 0, 0, 0, 0, 0, 0, 0, 0, 0, 0, 0, 0]
        ]
}
